##############
#.     #    .#
# $$@        #
#     $#$    #
#.          .#
##############
