#######
#  .  #
# $$@ #
#  .  #
#     #######
#############
