#######
#  .  #
# $$@ #
#  .  #
#######
