###############
#     .       #
# $$$ ###     #
#         .   #
#   # @ # .   #
###############
