#######
#  .  #
# $$@ #
#  .  #
#     #######
#           #
#  .        #
# $$        #
#  .        #
#############
