##########
#.@  #   #
#$$ # $$ #
#.  .   .#
##########





