#####
#.@ #
#$$ #
#  .#
#####
