###############
#        #.   #
# $$@  .#     #
#      #.   $ #
#             #
##        #####
###############