################
#     #       .#
# $$$ # ##### ##
#  .  #     . #
# ### ## ## # #
#   @         #
# ####### # ###
# .     $     #
###############
