###############
#     .       #
# $$$ ###     #
#   #   # .   #
#   # @ # .   #
###############
