##############
#.     #     #
# $$@        #
#     $#$    #
#           .#
## ####     ##
##          ##
#.    ##   ###
##           #
#    ###   ###
#   ###     .#
##############